Team,GP,W,D,L,GF,GA,GD,PTS,
Chelsea,26,18,6,2,56,22,34,60,
Man City,26,16,7,3,56,25,31,55,
Arsenal,26,14,6,6,49,29,20,48,
Man United,26,13,8,5,44,26,18,47,
Southampton,25,14,4,7,38,17,21,46,
Tottenham,25,13,4,8,39,34,5,43,
Liverpool,25,12,6,7,36,29,7,42,
West Ham,25,10,8,7,36,28,8,38,
Swansea City,26,10,7,9,30,34,-4,37,
Stoke City,26,10,6,10,30,34,-4,36,
